0011111111111111000001111111110000000000111111111111100000111111
1011111111111000011101111100000111111110111111111111101110111111
1011111111111011111101111101111111111110111111111111101110000111
1011111111111011111101111101111111111110111111111111101111110111
1000000000111011100001111101111000011110111111111111101111110111
1111111110000011101111111101111011010000111111111111101111110111
1111111110111111101111111100000011000111111000000001101100000111
1111111110111111101111111111111111011111111011111101101101111111
1000000010111111100000000000000000000000000000000001101101111111
1011111000111111111111111111111111111111111011111111101101111111
1011111111111111100000000011111111111111111011111111101101111111
1011111111111111101111111011111111111111111011111100001101111111
1011111111111111101111111011111111111111111000000001111101111111
1011111000000001100001111011111111111111111111111111111101111111
1011111011111101111101111011111111111111111111111111111101111111
1011000011111101111100000000800000000000000000000000000000000111
1011011111111101111101111011111111111111111111111011111101110111
1011011111111101111101111011111111111111000000000011111101110111
1000011111111101111101111011111111111111011111111111111100000111
1111011111111101111101111011111111111111000000000000111111111111
1111011111111101111101111011111111111111111111111110111111111111
1110000000000001111101111000000000000000000000000000111111110001
1110111111111111111101111111101111111111111111111111111111110101
0000111111111111111101111111101111111111111110000001111111110101
0111111111111111000001111111101111111111111110111101111111110101
0000000000011111011111111111101111000000000000000001111100010101
1111111111011111011111111111101111011111111110111111111101010101
1111111111011000011111111111100000011111111110000000000001010101
1111111111000011111111111111111111111111111111111111111111000100