0111111111
0111111111
0000111111
1110111111
1110123111
1110111111
1110011111
1111011111
1111000001
1111111100
